######### #########
#.......# #.......#
#.......|.|.......#
#.......# #.......#
######### #########